5 2 2 2 2 6 0 0 5 2 2 2 6 0 0 0 0 0 0 0 0 0 5 2 2 2 2 2 2 6
5 1 1 1 1 4 2 2 2 1 1 1 4 2 2 2 2 2 2 6 0 0 5 1 1 1 1 1 1 3
5 1 1 1 1 1 1 1 1 1 1 1 1 1 1 1 1 1 1 3 0 0 5 1 1 1 1 1 1 3
5 1 1 1 1 1 1 1 1 1 1 1 1 1 1 1 1 1 1 3 0 0 5 1 1 1 1 1 1 3
5 1 1 1 1 3 5 5 5 1 1 1 3 5 5 5 5 1 1 3 0 0 5 1 1 1 1 1 1 3
5 5 1 1 3 5 0 0 5 5 5 5 5 0 0 0 5 1 1 3 0 0 5 1 1 1 1 1 1 3
0 5 1 1 3 0 0 0 0 0 0 0 0 0 0 0 5 1 1 3 0 0 5 1 1 1 1 1 1 3
0 5 1 1 4 2 2 2 2 2 2 2 6 0 0 0 5 1 1 3 0 0 5 5 5 1 1 3 5 5
0 5 1 1 1 1 1 1 1 1 1 1 3 0 5 2 2 1 1 4 2 6 0 0 5 1 1 3 0 0
0 5 1 1 1 1 1 1 1 1 1 1 3 0 5 1 1 1 1 1 1 3 0 0 5 1 1 3 0 0
0 5 5 5 5 5 5 5 5 1 1 1 3 0 5 1 1 1 1 1 1 3 5 2 2 1 1 3 0 0
5 2 2 2 2 2 2 2 2 2 1 1 3 0 5 1 1 1 1 1 1 4 2 1 1 1 1 3 0 0
5 1 1 1 1 1 1 1 1 1 1 1 3 0 5 1 1 1 1 1 1 1 1 1 1 1 1 3 0 0
5 1 1 1 1 1 1 1 1 1 1 1 3 0 5 1 1 1 1 1 1 1 1 1 1 1 1 3 0 0
5 1 1 1 3 5 5 5 5 5 5 5 5 0 5 5 5 5 5 5 5 5 5 1 1 1 1 3 0 0
5 5 5 5 5 0 0 0 0 0 0 0 0 0 0 0 0 0 0 0 0 0 5 5 5 5 5 5 0 0
